111111111111111
1B00PCCCBCCECC1
1000000CCCC0CC1
1F0B000CBCCCCC1
111111111111111
