1111
1111
1F11
1111
1E11
1P11
1C11
1111